--------------------------------------------------------------------------------------------------------------------------------------------------------------------------------------------------------
--------------------------------------------------------------------------------------------------------------------------------------------------------------------------------------------------------
--------------------------------------------------------------------------------------------------------------------------------------------------------------------------------------------------------
--------------------------------------------------------------------------------------------------------------------------------------------------------------------------------------------------------
--------------------------------------------------------------------------------------------------------------------------------------------------------------------------------------------------------
--------------------------------------------------------------------------------------------------------------------------------------------------------------------------------------------------------
-----------------#-----------------------SSS--SSS-------------------------------------SSS------------------------------S!S-------------------------------------------@-----------------------SSSSS------
-----------------------------------------------------------------------------------------------------------------------------------------------------------------------------------------------S--------
-----------------#----------------------------------------------------------------------------------------------------------------------------------------------!---------------------------------------
----------------##----------------------------------------------------------------------------------------------------------------------#---------------------------------------------------------------
---------------####---------------@@S!------------------##------SUU--------------SSU------------!-------------SS--S----S----------##--####-##---#-t-----------------------------------------------------
--------------#####-------------------------------------###---------------------------------------------------------------------####--####--##--##------------------------------------------------------
--------------##-##---------------------------------##--####---------------------------------------------------------------tt--#####--###---##--##-t---------------------##-----------------------------
-------------###-###-----------------------------gg###--####-g----------------gg-------------------------g-g---------gg----ttt######--###--###--###t------------g-------####---g--------------------#---
XXXXXXXXXXXXXXXX-XXXXXXXXXXXXXXXXXXXXXXXXXXXXXXXXXXXXX--XXXXXXXXXXXXXXXXXXXXXXXXXXXXXXXXXXXXXXXXXXXXXXXXXXXXXXXXXXXXXXXXXXXXXXXXXXXX--XXX---XX-XXXXXXXXXXXXXXXXXXXXXXXXXXXXXXXXXXXXXXXXX-XXXXXXXXXXXXXXX
XXXXXXXXXXXXXXXXXXXXXXXXXXXXXXXXXXXXXXXXXXXXXXXXXXXXXXXXXXXXXXXXXXXXXXXXXXXXXXXXXXXXXXXXXXXXXXXXXXXXXXXXXXXXXXXXXXXXXXXXXXXXXXXXXXXXXXXXX--XXX-XXXXXXXXXXXXXXXXXXXXXXXXXXXXXXXXXXXXXXXXXXXXXXXXXXXXXXXXX